#####F####
#00000##0#
##0##0000#
S00#00##0#
##########